....................
....................
....................
....................
....................
....B.....F.........
....................
...........CCC......
...........###......
......CCC...........
......###.......CCC.
................###.
.###................
....................
####################
